5 5
6 7 3 9 1
8 5 8 3 3
1 9 1 9 3
8 5 3 5 4
6 3 1 1 3
1 4 7
2 2 8
