5 5
6 9 2 3 2
6 6 3 1 2
2 4 6 5 6
9 3 9 5 1
3 2 3 4 7
3 3 2
3 3 8
