5 5
7 9 7 1 6
7 5 5 9 8
6 1 2 7 5
3 5 5 5 9
8 1 9 1 7
0 0 2
4 4 8
