5 5
6 5 2 3 7
3 3 4 7 7
6 6 7 3 4
4 7 8 4 6
3 6 1 4 5
2 0 1
2 4 8
