5 5
6 8 2 2 3
5 5 7 1 6
7 6 6 3 4
7 9 1 3 7
4 7 4 1 9
1 1 5
0 4 8
