5 5
5 1 3 5 8
7 5 4 4 6
6 5 7 7 8
3 6 9 3 3
8 8 6 8 6
0 0 6
4 4 8
