5 5
2 1 3 5 9
8 9 6 8 7
1 2 1 5 3
7 4 6 3 3
3 4 5 9 1
4 0 8
4 0 8
