5 5
7 8 2 8 6
7 7 7 6 2
3 5 8 2 7
8 8 6 1 2
2 8 4 4 6
0 0 7
4 4 8
