5 5
3 2 6 6 4
9 5 4 6 3
6 4 4 8 1
6 3 1 1 5
2 9 1 5 5
4 2 5
2 0 8
