5 5
7 9 2 7 9
3 2 4 1 9
7 7 8 9 8
5 8 3 7 5
5 5 7 1 6
0 0 6
4 4 8
