5 5
9 9 9 9 7
1 1 3 4 7
4 9 2 5 4
5 3 3 8 7
1 2 8 9 6
1 0 1
1 4 8
