5 5
4 6 9 9 6
1 9 7 8 7
9 4 6 4 3
5 9 2 1 3
5 3 3 6 4
0 0 7
4 4 8
