5 5
7 7 5 2 7
4 5 4 6 7
6 8 7 3 7
8 8 5 5 7
6 5 2 9 1
4 0 0
2 1 8
