5 5
6 3 8 4 7
7 4 3 1 2
3 2 2 2 2
6 7 2 6 1
8 6 5 8 7
0 0 2
4 4 8
