5 5
5 4 2 4 1
3 6 3 9 4
5 5 9 6 6
5 5 2 1 5
4 9 1 8 1
0 0 5
4 4 8
