5 5
2 4 2 4 5
7 7 5 1 5
6 5 1 3 3
2 1 2 1 9
1 1 4 5 1
2 0 8
2 1 8
