5 5
5 5 5 4 9
3 4 2 5 4
4 2 2 9 7
7 2 8 8 2
9 3 7 4 6
0 0 7
4 4 8
