5 5
7 9 5 9 3
7 4 9 8 5
9 5 9 2 9
3 3 2 2 4
3 3 7 3 3
0 0 3
4 4 8
