5 5
3 9 2 9 3
2 8 8 9 6
6 8 1 6 7
5 1 7 1 4
7 6 8 3 6
1 4 0
1 1 8
