5 5
9 5 7 3 9
3 5 1 8 1
3 2 9 1 2
2 8 3 3 8
8 3 1 9 8
0 0 1
4 4 8
