7 7
8 1 8 4 9 9 1
2 2 2 6 2 2 8
3 1 3 4 8 4 3
3 6 5 3 6 4 6
4 6 7 5 6 7 4
4 1 7 9 4 7 8
2 9 3 1 7 1 4
0 0 5
6 6 8
