7 7
6 8 4 6 8 7 7
7 1 5 2 6 1 7
2 5 9 9 9 6 7
9 1 4 2 3 6 1
8 4 9 7 7 9 2
2 3 5 4 7 9 9
9 4 7 1 3 4 5
5 5 5
4 1 8
