7 7
2 6 5 6 4 8 6
3 3 3 7 9 3 1
6 6 2 1 5 9 4
6 4 3 1 1 7 6
7 4 5 2 1 7 5
1 4 1 8 3 2 9
4 8 1 4 4 5 9
0 0 1
6 6 8
