7 7
5 8 1 8 4 1 7
1 2 3 2 8 3 7
4 1 2 6 1 1 4
2 9 9 7 2 3 8
3 2 4 7 2 2 2
8 1 2 6 3 4 3
9 6 8 1 8 4 3
0 0 4
6 6 8
