7 7
7 7 2 7 3 1 7
1 2 8 9 2 5 4
3 3 3 2 4 9 7
8 1 6 5 8 1 1
4 8 1 4 8 5 8
2 2 7 4 6 3 1
4 9 1 4 7 2 7
0 0 3
6 6 8
