7 7
7 5 7 7 1 7 8
5 7 7 4 8 1 7
7 4 7 6 8 1 3
4 3 8 9 9 3 5
7 1 9 5 6 2 5
4 1 2 8 9 5 8
7 2 7 4 7 4 4
0 0 2
6 6 8
