7 7
8 4 5 2 5 4 6
7 3 5 2 4 9 6
6 6 8 3 9 5 2
7 5 7 9 5 3 4
8 8 5 1 3 5 5
5 4 9 2 4 3 8
7 9 4 1 7 1 9
2 2 5
1 1 8
