7 7
7 6 1 3 7 3 4
3 9 9 9 8 8 6
8 2 7 3 9 1 9
1 3 6 5 7 2 3
1 4 2 3 5 8 8
9 5 4 7 6 8 4
4 1 1 7 9 3 9
6 6 3
5 1 8
