7 7
5 6 3 5 2 2 9
8 7 3 3 5 4 1
9 5 5 1 8 1 7
6 2 3 1 7 6 5
8 9 5 4 7 4 2
3 5 4 3 1 9 9
1 5 4 2 6 7 5
0 0 5
6 6 8
