7 7
1 1 8 1 1 4 7
1 2 8 6 2 7 5
6 6 1 6 4 5 5
3 7 8 9 5 7 5
5 5 1 7 8 6 5
5 6 5 1 9 4 3
8 6 3 8 9 9 9
3 0 7
6 6 8
