7 7
2 6 1 8 1 3 3
1 4 4 8 1 8 9
4 2 2 4 1 9 7
4 6 4 3 8 8 4
9 4 8 7 4 6 2
8 2 2 3 7 9 6
8 2 1 9 1 2 8
0 0 1
2 0 8
