7 7
3 6 1 9 6 5 2
2 1 8 5 2 5 5
6 5 4 8 6 3 4
7 4 4 2 4 8 7
6 1 3 3 9 2 3
4 2 1 3 4 7 7
7 4 3 5 5 3 5
0 0 2
6 6 8
