7 7
8 1 5 5 1 4 1
8 5 9 7 8 1 9
1 6 8 6 9 2 1
1 6 8 2 3 4 1
3 4 3 7 4 9 3
3 2 7 3 2 8 2
5 6 8 5 7 5 7
0 0 2
6 6 8
