7 7
8 5 5 9 6 8 3
8 9 7 6 5 3 3
9 7 4 4 8 1 2
8 7 4 6 7 1 7
3 5 1 6 6 1 7
3 3 7 2 1 7 8
8 1 8 4 1 1 5
4 1 5
4 4 8
