7 7
6 6 7 3 7 6 5
2 2 1 6 2 4 6
9 5 2 2 2 8 7
7 7 2 5 6 1 3
4 6 1 7 5 3 7
7 6 5 2 8 9 7
4 3 2 2 1 2 6
0 0 3
6 6 8
