7 7
8 7 1 4 7 8 9
8 5 5 3 6 7 3
1 7 3 7 1 4 7
5 1 9 5 1 8 9
5 5 8 1 1 5 8
6 6 4 2 6 2 8
4 2 1 6 7 7 5
4 2 8
6 4 8
