7 7
5 7 7 5 3 3 8
2 3 9 1 4 1 3
6 8 3 6 2 9 9
7 3 5 9 9 8 1
1 8 8 5 4 4 6
5 2 5 4 4 1 4
4 7 1 8 1 2 7
6 2 8
2 5 8
