7 7
3 2 1 5 4 7 1
1 9 6 4 9 5 4
5 4 7 1 4 7 9
5 9 1 7 2 1 2
5 9 4 5 4 1 2
3 9 2 1 9 2 5
3 4 5 4 3 4 9
6 3 1
4 0 8
