7 7
6 7 8 2 4 1 2
6 1 2 9 1 6 5
6 4 6 8 6 4 5
2 4 9 6 4 8 5
6 7 1 1 6 1 5
4 5 9 9 8 8 1
9 1 9 8 5 2 2
0 0 1
6 6 8
