7 7
9 4 5 9 3 4 9
3 3 7 7 2 6 7
5 8 7 3 8 7 9
6 9 4 2 6 7 7
9 7 5 9 3 1 3
5 5 5 4 2 8 6
9 6 8 4 5 5 6
0 6 6
5 3 8
