5 5
9 6 5 5 1
5 6 3 8 2
3 3 5 3 7
7 1 2 3 7
1 2 5 5 4
4 1 4
4 0 8
