5 5
9 6 4 9 1
2 6 3 1 4
2 9 7 9 5
7 1 1 2 6
1 9 5 4 1
0 0 1
4 4 8
