5 5
6 7 6 6 9
5 4 6 1 5
2 5 5 5 8
9 6 6 5 8
5 4 9 7 2
0 0 7
4 4 8
