5 5
2 8 6 6 5
7 6 7 8 5
8 9 7 7 1
4 4 7 5 6
1 3 6 3 4
0 0 1
4 4 8
