5 5
4 8 6 4 9
7 9 8 1 5
7 8 6 2 7
1 7 6 8 1
9 7 5 7 6
0 4 1
0 4 8
