5 5
5 3 4 6 2
7 5 7 4 5
5 6 5 8 3
4 8 7 5 7
9 4 6 9 4
0 0 5
4 4 8
