5 5
2 1 6 8 3
1 4 4 8 8
7 3 4 3 8
3 8 2 2 9
2 7 7 4 2
1 1 6
1 4 8
