5 5
3 7 3 9 9
4 2 9 7 6
5 5 1 3 2
5 1 4 5 1
1 2 6 8 5
0 0 6
4 4 8
