5 5
7 8 4 6 7
9 2 5 6 3
5 2 9 2 1
3 1 3 1 8
8 6 6 3 1
2 0 7
2 0 8
