5 5
9 2 7 9 1
9 7 7 5 8
9 9 1 3 2
1 6 4 8 4
9 8 9 9 4
0 0 2
4 4 8
