5 5
3 9 9 5 9
2 1 2 4 7
9 6 4 3 2
6 1 2 1 2
7 2 4 7 8
3 1 4
1 1 8
