5 5
5 3 5 7 8
9 5 2 8 6
3 3 5 1 3
1 2 9 3 6
7 4 2 5 1
0 0 2
4 4 8
