5 5
1 7 1 2 6
7 6 2 9 6
1 4 4 7 6
1 2 3 1 6
3 3 9 6 5
1 0 5
0 1 8
