5 5
9 8 2 6 5
8 4 7 3 2
9 4 2 9 6
1 2 6 9 4
9 4 3 6 6
3 3 1
0 2 8
