5 5
9 6 3 1 5
3 4 6 8 5
7 6 3 7 2
4 7 3 7 5
1 3 5 9 5
0 0 1
4 4 8
