5 5
4 8 5 5 8
7 9 5 8 4
1 4 7 2 6
9 9 6 1 2
7 5 7 4 3
3 1 2
0 2 8
