5 5
5 6 6 8 4
2 1 3 6 1
1 9 9 6 1
5 2 4 1 2
8 6 9 8 8
0 0 4
4 4 8
