5 5
6 5 3 5 6
5 6 7 3 3
6 7 7 6 2
9 9 6 1 3
6 9 7 2 1
4 0 4
1 1 8
