5 5
9 7 6 4 9
8 9 5 9 8
4 4 9 4 5
7 1 2 7 4
1 2 4 9 8
2 2 5
1 1 8
