5 5
7 7 5 7 9
7 8 9 5 8
6 2 6 6 4
1 7 1 7 4
1 9 9 9 6
0 0 4
4 4 8
