9 9
3 4 8 9 7 4 1 6 1
6 7 1 4 4 3 5 9 2
4 6 7 9 7 5 5 1 7
9 9 9 2 2 1 5 3 1
2 1 1 5 3 3 5 4 5
9 3 2 6 8 6 2 6 1
1 8 1 3 6 5 5 9 1
7 9 2 1 9 6 7 8 9
7 3 5 8 1 8 8 1 4
0 0 5
8 8 8
