9 9
4 8 2 4 2 5 8 4 7
3 9 8 6 4 2 1 5 8
1 3 3 4 8 8 6 3 5
1 7 3 1 8 6 5 1 3
2 3 3 2 4 6 7 1 2
9 1 4 8 4 1 4 9 9
8 3 6 3 6 7 6 8 9
1 1 2 6 9 5 4 8 3
1 6 9 8 7 3 3 6 7
0 7 1
7 4 8
