9 9
5 6 8 1 7 2 4 8 7
9 9 7 6 2 8 4 5 5
1 8 1 1 7 3 5 2 5
6 9 7 7 7 2 1 7 6
9 8 8 8 4 8 7 6 6
9 4 1 9 2 7 9 6 9
5 9 9 7 9 3 5 8 5
8 1 8 9 3 2 5 3 7
8 9 8 4 5 1 1 7 5
0 0 3
8 8 8
