9 9
3 9 5 9 4 5 7 6 7
7 9 8 7 9 6 6 1 3
9 2 1 8 5 2 6 4 7
4 6 3 3 6 2 3 3 9
7 4 1 4 3 2 1 9 5
3 8 2 3 3 5 3 7 6
4 6 2 7 8 8 3 5 2
1 9 9 7 1 1 4 2 6
5 5 4 1 2 2 6 2 5
0 0 3
8 8 8
