9 9
7 3 8 8 2 7 9 7 3
4 1 1 9 2 6 3 1 5
4 3 4 8 9 9 8 9 2
1 9 3 8 1 5 3 7 8
3 8 2 1 6 9 2 9 6
7 6 5 8 3 1 2 6 7
1 2 1 8 7 2 8 1 2
5 4 7 2 5 8 2 2 1
6 7 3 4 7 9 9 7 3
1 2 3
3 6 8
