9 9
3 5 4 2 2 7 9 1 1
3 3 4 4 2 7 6 3 1
8 6 8 9 3 4 6 9 1
5 3 5 9 6 4 4 1 5
3 4 2 8 9 2 7 4 9
9 3 7 1 9 7 2 9 3
6 8 3 4 7 8 5 5 1
4 3 2 4 6 2 9 9 4
6 9 7 8 6 9 4 4 7
6 1 8
5 3 8
