9 9
6 5 2 9 7 6 3 1 2
6 2 5 2 9 3 5 4 6
9 4 3 3 9 2 4 3 2
7 4 4 7 3 8 8 5 2
9 4 7 2 3 1 8 2 9
8 1 6 8 2 1 3 3 8
8 8 5 1 6 4 1 3 5
2 3 4 8 7 3 9 1 4
7 4 7 5 7 5 3 3 6
6 1 0
2 5 8
