9 9
3 6 7 6 1 4 1 8 1
1 2 6 6 7 3 7 7 1
1 1 4 1 2 3 7 7 4
8 2 3 4 5 3 8 5 5
2 1 6 4 7 3 1 3 2
3 7 7 3 1 8 4 1 1
7 2 4 2 9 9 6 2 9
3 4 3 6 8 1 1 3 6
4 7 7 4 3 6 4 3 3
0 0 7
8 8 8
