9 9
9 6 3 6 9 2 3 2 1
2 2 5 4 1 7 7 4 4
4 8 8 5 9 1 2 9 6
5 1 8 5 2 8 3 4 5
2 7 6 3 7 7 9 7 1
6 8 1 3 9 8 6 9 3
8 6 5 4 2 5 1 2 8
1 6 1 4 3 7 5 1 6
6 6 1 9 2 8 3 4 9
0 0 4
8 8 8
