9 9
3 7 4 6 8 4 9 7 8
6 8 3 5 5 7 7 5 7
2 1 5 3 1 8 2 9 8
8 2 9 6 4 8 9 3 3
8 3 6 3 5 3 6 6 2
8 8 1 6 6 2 6 7 9
5 4 2 9 1 6 2 4 4
9 1 6 5 8 2 2 9 7
5 1 4 3 6 7 9 2 4
4 7 6
5 1 8
