9 9
7 2 4 2 2 8 4 1 5
9 9 3 8 5 9 6 1 6
5 2 1 2 4 2 4 5 9
3 5 8 9 4 2 7 8 6
8 6 9 5 1 1 1 4 7
4 5 2 2 6 4 2 8 4
1 4 1 6 8 5 1 3 9
5 8 6 3 1 2 6 6 5
9 5 5 5 1 6 2 6 3
0 0 1
8 8 8
