9 9
1 4 9 9 1 5 2 4 3
4 4 5 5 4 8 6 3 6
6 9 3 5 7 8 9 9 9
1 7 6 6 7 8 5 2 3
6 3 9 8 9 2 6 4 4
8 2 3 6 4 2 4 4 1
6 3 1 4 2 7 5 8 7
7 5 9 2 8 7 6 5 1
7 9 1 1 5 5 9 7 9
4 0 3
0 4 8
