9 9
1 4 8 8 8 3 5 2 7
5 4 3 1 2 8 1 7 5
1 7 7 4 8 9 4 1 8
4 5 6 9 7 2 7 2 1
3 3 8 8 3 5 9 9 8
8 7 1 4 3 9 4 1 9
9 4 8 2 7 1 7 3 6
1 7 4 3 3 7 5 8 2
9 8 1 5 4 3 1 4 6
7 0 3
6 6 8
