9 9
8 7 7 3 5 3 6 5 6
1 1 2 2 1 2 3 5 4
3 7 3 4 3 1 2 7 3
3 8 8 3 7 9 8 6 3
5 8 8 8 7 3 8 6 8
5 5 8 3 8 9 7 9 4
3 9 5 5 6 9 7 1 5
1 5 1 9 9 9 1 7 3
9 8 7 6 7 9 9 6 2
5 6 2
3 5 8
