9 9
8 9 7 1 8 5 2 1 5
7 9 5 2 5 2 7 5 1
8 2 5 5 7 3 4 8 1
1 6 6 9 2 5 1 5 3
7 7 3 3 5 6 5 4 8
9 4 5 6 2 8 9 4 5
4 3 4 8 2 6 3 3 5
1 5 8 9 4 6 7 1 7
8 9 4 1 8 4 1 7 1
1 1 8
6 5 8
