9 9
5 2 7 8 5 3 2 9 3
8 4 1 1 9 6 3 4 5
6 9 8 3 1 6 7 4 2
9 9 9 4 4 3 7 8 6
2 5 4 6 8 5 3 7 9
3 9 1 4 1 7 8 8 8
5 3 9 6 4 1 2 9 9
3 3 6 2 9 8 4 6 7
9 8 2 7 9 8 3 2 3
0 0 5
8 8 8
