9 9
5 2 3 6 9 4 4 5 1
6 2 4 1 1 7 7 7 4
1 1 5 1 1 1 4 4 2
1 8 4 7 9 9 8 6 4
5 1 2 7 5 8 7 7 8
5 1 2 8 6 1 3 4 3
8 3 6 2 7 9 2 9 9
3 7 6 3 9 1 4 2 2
1 6 2 6 2 8 9 8 1
0 0 4
8 8 8
