9 9
7 2 9 1 6 4 4 8 4
2 5 6 9 6 8 3 8 3
2 9 1 1 5 7 6 2 3
2 8 7 6 7 7 2 7 7
7 2 6 6 9 9 7 9 9
7 1 8 6 4 5 4 7 6
1 2 6 3 6 8 6 2 9
4 9 2 2 5 4 1 2 3
1 1 8 1 5 9 8 1 3
0 0 1
8 8 8
