9 9
7 7 9 8 4 8 3 1 6
9 2 5 5 3 8 2 6 7
2 2 4 4 4 7 2 8 7
2 9 5 7 9 1 5 7 2
4 9 6 7 9 6 7 5 2
7 6 9 8 9 1 6 4 2
4 4 1 4 8 9 9 3 5
9 5 4 1 6 3 8 4 1
8 8 5 5 2 8 1 9 8
0 0 6
8 8 8
