9 9
7 4 8 5 5 6 2 3 6
3 7 2 2 2 1 2 6 1
9 4 6 8 2 3 4 4 4
7 4 4 3 9 2 9 5 6
8 6 2 1 3 2 4 4 6
4 1 6 6 9 3 6 6 3
1 2 2 1 4 4 8 8 9
7 6 5 5 4 2 2 9 2
2 4 4 1 5 2 9 5 9
6 0 0
0 5 8
