7 7
7 5 4 3 8 3 5
6 1 2 8 9 3 7
3 7 3 9 6 3 9
5 2 4 1 8 1 3
3 8 1 4 7 1 6
3 5 1 6 2 1 4
4 9 4 2 3 2 6
3 5 1
5 4 8
