7 7
7 6 1 5 8 8 7
6 3 2 7 6 7 4
4 8 8 4 4 4 7
7 1 6 6 8 1 9
4 3 9 7 4 4 9
8 5 2 5 7 4 4
2 1 2 8 8 7 3
6 2 4
4 5 8
