7 7
9 3 7 4 7 2 6
2 9 9 9 2 4 3
6 5 1 6 1 2 8
8 5 4 4 7 7 4
6 5 6 8 8 8 7
1 4 7 2 5 1 7
5 8 1 3 5 3 4
4 3 4
1 6 8
