7 7
5 8 1 8 5 5 8
5 8 7 4 3 1 9
7 7 2 6 1 7 7
7 3 2 4 7 6 7
2 5 9 7 1 1 1
6 2 1 4 9 9 6
1 6 4 7 4 5 4
4 5 4
5 0 8
