7 7
4 8 5 2 3 7 7
5 1 9 5 9 8 4
1 8 9 4 2 9 2
3 8 9 8 6 6 1
5 4 4 2 4 7 5
7 1 2 3 3 1 2
8 7 9 3 9 2 6
0 0 5
6 6 8
