7 7
1 4 6 6 5 4 5
7 1 1 8 1 3 1
6 3 4 5 8 9 7
2 2 6 3 3 2 3
1 6 2 2 5 8 7
9 8 4 8 1 1 4
5 6 1 7 6 8 2
0 6 2
6 6 8
