7 7
7 9 2 5 8 2 6
4 8 3 5 3 3 8
4 8 2 1 9 2 1
2 7 3 3 7 1 8
4 8 7 2 4 8 7
9 8 6 8 4 7 7
8 3 8 4 6 5 5
0 0 5
6 6 8
