7 7
1 2 8 9 8 8 4
8 7 6 8 2 8 2
4 7 5 4 4 8 2
3 8 8 4 2 7 4
2 9 3 8 8 9 6
5 7 8 4 1 3 4
2 3 5 3 3 8 9
0 5 2
3 1 8
