7 7
3 3 3 3 3 3 1
2 4 9 3 9 2 4
1 4 9 3 3 9 1
7 8 3 3 4 8 7
8 8 7 8 9 5 9
9 4 5 4 4 9 8
3 5 9 4 4 7 5
2 0 5
6 4 8
