7 7
7 7 4 3 2 7 4
3 9 9 9 3 9 5
3 5 7 2 2 5 5
4 5 8 4 5 8 5
9 9 3 2 8 7 4
4 8 5 5 5 4 7
1 2 2 8 8 9 9
0 0 3
6 6 8
