7 7
1 9 5 4 4 2 3
5 2 1 9 6 4 7
7 7 1 5 1 8 6
4 6 2 9 7 4 6
3 1 1 8 1 7 4
3 2 7 1 6 9 9
7 7 6 2 3 5 6
0 0 2
6 6 8
