7 7
3 7 8 3 3 2 4
8 5 7 9 9 3 2
8 3 2 1 5 1 6
9 3 6 1 5 4 5
4 9 4 6 3 5 1
7 4 5 9 6 2 1
8 5 1 4 4 6 5
6 5 6
4 5 8
