7 7
2 8 5 9 5 3 3
9 9 5 7 9 9 1
2 6 9 1 4 6 9
9 4 3 3 9 1 1
6 4 6 6 5 8 9
6 1 2 9 2 2 4
5 1 6 2 6 3 4
0 0 7
6 6 8
