7 7
9 4 8 1 3 4 1
1 6 3 5 8 2 3
8 2 7 5 2 1 5
7 5 3 4 4 2 8
8 5 1 8 5 9 8
6 4 3 5 9 4 8
5 9 5 1 1 8 5
0 0 1
6 6 8
