7 7
7 8 1 1 6 3 5
2 4 4 2 1 8 7
1 6 3 3 6 3 6
3 6 5 7 9 8 1
6 4 1 6 1 4 3
3 4 9 8 6 2 1
3 1 1 1 4 6 9
0 0 4
6 6 8
