7 7
7 8 4 1 1 7 7
6 3 7 7 2 1 2
7 4 2 9 1 6 9
1 3 9 6 2 5 4
3 1 4 2 1 9 2
7 6 8 5 7 5 6
7 8 8 2 2 6 8
0 6 5
3 2 8
