7 7
5 9 9 6 1 8 4
1 2 2 2 8 9 7
2 2 5 4 3 3 5
6 7 8 7 2 4 1
3 8 9 1 8 1 8
9 3 7 2 4 3 4
5 2 6 2 5 6 4
0 0 3
6 6 8
