7 7
8 7 6 4 8 7 5
1 5 7 2 5 3 2
4 4 5 6 5 9 2
9 3 4 5 1 4 7
2 7 8 6 4 7 5
4 4 3 8 1 9 2
2 6 7 8 7 7 1
0 0 7
6 6 8
