7 7
7 9 7 4 5 2 4
4 9 3 9 5 8 1
2 8 7 6 5 6 3
9 6 3 4 5 5 1
6 5 2 1 9 3 4
6 7 5 3 2 1 2
1 2 6 7 8 5 5
0 0 2
6 6 8
