7 7
9 5 5 4 1 2 2
6 9 5 8 7 3 5
8 8 7 7 8 9 1
8 7 6 7 7 2 7
6 3 7 1 2 7 5
7 5 6 1 7 1 6
5 2 9 1 7 8 7
2 6 4
0 1 8
