9 9
5 9 6 7 7 3 3 1 8
7 4 5 7 7 2 4 1 2
7 1 8 1 2 5 3 2 8
2 8 4 5 7 7 2 8 2
8 2 2 3 6 9 3 6 5
5 8 8 4 8 3 2 3 3
1 2 2 9 5 5 1 7 8
5 5 4 1 4 3 8 8 4
3 1 8 6 3 2 8 2 1
0 0 1
8 8 8
