9 9
2 4 4 6 9 9 6 5 7
4 7 5 5 1 5 5 2 3
6 2 2 5 7 3 6 6 9
2 5 4 3 9 9 8 5 2
7 3 6 4 8 8 8 5 7
6 1 7 1 5 2 8 3 5
3 2 2 4 5 5 3 3 1
6 3 6 3 3 5 9 2 7
1 8 7 4 5 6 9 3 3
8 1 0
6 3 8
