9 9
6 2 6 1 1 7 7 4 6
6 9 9 7 4 5 4 6 4
8 9 3 5 9 5 5 2 6
2 7 2 4 1 5 6 6 4
8 8 8 1 3 3 2 7 6
6 7 3 1 6 6 3 2 9
9 8 4 1 8 4 7 8 5
9 4 5 9 2 8 8 1 9
8 6 6 7 2 1 7 6 1
0 2 6
4 6 8
