9 9
1 7 6 1 8 8 7 3 5
1 6 9 7 7 7 5 7 2
9 8 8 6 1 4 2 9 6
3 8 6 2 1 7 5 8 1
2 9 9 4 1 5 4 2 6
3 9 8 9 9 4 4 1 5
9 8 8 8 2 5 5 3 5
5 4 9 1 7 7 7 5 2
7 6 4 7 9 7 8 7 9
7 0 1
4 2 8
