9 9
8 1 4 4 7 7 3 3 9
6 8 2 1 4 3 1 4 4
4 4 8 8 7 8 7 5 5
4 4 8 6 8 5 4 1 5
6 9 1 2 4 1 4 9 1
7 1 1 8 6 7 4 7 4
3 3 7 8 4 9 5 4 6
3 1 8 1 1 9 8 2 8
9 1 7 4 5 3 8 9 5
0 0 2
8 8 8
