9 9
7 5 8 3 3 8 6 4 6
9 1 3 7 4 6 6 2 2
5 4 3 3 1 4 8 9 8
7 4 4 6 1 7 7 6 2
2 1 8 9 7 2 8 8 9
7 9 4 3 2 8 6 5 3
2 6 2 9 8 4 2 8 9
4 3 9 7 3 9 4 2 5
4 7 4 6 8 9 1 9 8
0 0 4
8 8 8
