9 9
4 6 3 3 9 3 4 7 2
2 5 8 7 8 2 4 1 6
7 7 5 2 5 9 8 7 1
4 2 1 1 4 8 5 8 5
1 1 7 3 2 9 5 6 4
3 9 5 2 8 5 5 9 1
5 4 5 5 1 8 7 2 1
6 7 4 8 3 1 2 7 6
7 5 8 6 5 1 4 1 8
0 0 3
8 8 8
