9 9
5 4 6 4 7 9 6 7 6
6 2 6 7 1 4 2 7 5
5 9 3 4 4 4 4 9 1
7 5 4 3 8 8 5 3 9
7 6 1 9 7 4 3 6 9
8 1 9 6 8 1 8 6 9
6 4 1 6 7 6 4 7 1
3 7 6 9 2 4 5 4 6
6 8 3 3 2 1 4 7 4
0 0 5
8 8 8
