9 9
1 6 5 3 5 6 1 2 2
5 1 7 1 5 1 2 6 6
8 8 9 4 9 9 3 1 9
2 7 6 4 2 1 4 1 7
8 6 9 2 9 3 2 2 4
3 3 2 5 7 5 3 3 4
4 4 6 7 8 3 4 6 9
6 4 9 6 8 9 4 2 2
9 9 4 8 9 6 8 7 2
1 2 6
6 3 8
