9 9
9 7 6 2 9 9 5 1 9
2 9 2 1 3 4 4 7 5
1 2 5 9 1 2 2 7 7
5 3 2 1 3 8 4 8 3
1 3 3 6 4 2 4 2 2
2 7 9 7 5 2 3 7 1
3 3 5 6 1 3 3 7 5
2 1 4 3 8 2 5 8 3
4 6 4 8 2 2 9 3 8
8 1 6
7 6 8
