9 9
6 3 6 1 7 8 5 9 1
2 9 4 8 3 1 2 2 6
4 3 9 2 1 6 7 2 4
7 2 8 1 3 8 1 1 7
5 8 1 5 9 1 3 9 5
3 7 4 4 9 3 2 2 5
8 7 7 8 9 3 5 4 7
7 9 7 1 9 8 7 2 9
9 3 5 4 3 9 2 7 2
0 0 3
8 8 8
