9 9
2 3 4 2 3 3 2 4 2
2 2 1 4 3 5 9 3 6
8 5 1 6 7 9 4 9 3
3 3 1 6 7 2 8 3 3
9 4 2 6 8 3 5 7 7
7 5 1 5 4 6 5 9 2
5 6 6 7 7 8 3 2 1
2 3 4 5 7 1 6 2 8
5 9 4 3 2 6 6 8 3
4 8 6
4 8 8
