9 9
3 9 7 1 1 8 7 2 2
7 9 2 4 3 1 2 2 4
8 3 3 6 8 4 9 7 2
9 5 6 1 3 1 1 4 9
5 7 3 5 3 3 7 8 8
4 1 6 7 4 8 6 6 3
1 8 5 4 4 8 9 2 7
5 2 7 2 3 4 7 5 3
7 6 8 3 5 6 2 2 6
0 1 3
1 7 8
