9 9
8 9 4 4 2 4 8 4 9
7 8 2 9 6 1 9 1 9
9 9 2 8 7 1 7 3 5
4 6 2 4 6 8 3 1 6
6 1 1 3 6 4 3 8 8
2 3 9 2 9 1 6 7 3
4 4 4 4 9 1 1 9 4
1 5 1 8 5 5 1 6 2
7 8 4 9 5 2 9 3 5
0 0 1
8 8 8
