9 9
1 3 8 6 5 6 4 3 4
9 6 6 1 1 8 7 3 4
9 8 6 2 3 6 7 8 4
8 8 8 6 3 2 2 7 9
7 2 7 7 9 4 2 7 6
3 9 6 3 8 3 2 5 2
2 3 4 8 5 9 1 7 4
2 9 8 1 4 2 2 7 6
9 7 7 5 7 9 4 2 9
0 0 5
8 8 8
