9 9
6 7 7 1 8 8 4 8 8
4 4 9 9 6 8 1 1 8
9 3 2 7 7 9 3 9 9
1 8 1 9 3 7 7 4 4
9 4 2 5 1 7 3 7 3
4 6 6 9 2 2 1 3 7
2 8 7 9 6 3 3 2 9
8 3 8 4 3 8 4 5 7
2 5 6 7 9 8 9 7 2
2 1 5
5 8 8
