9 9
3 6 6 6 3 7 8 7 8
1 4 7 7 6 8 4 7 7
9 3 9 8 7 8 2 3 3
5 4 4 4 8 9 7 6 7
7 1 1 9 5 3 7 8 9
6 7 1 9 9 3 5 2 7
3 3 4 1 3 3 4 4 1
5 5 2 9 1 3 9 4 5
2 8 2 7 9 8 5 7 6
7 5 6
5 5 8
