9 9
2 7 8 3 3 3 2 7 4
6 4 6 5 1 4 3 4 8
9 4 1 7 2 2 8 4 3
9 6 1 7 4 1 8 4 4
8 8 3 7 7 4 1 5 8
1 4 6 9 8 8 1 3 1
2 2 4 4 6 9 5 5 8
8 4 2 3 9 7 8 3 8
8 3 2 7 3 1 2 4 9
0 0 6
8 8 8
