9 9
5 5 7 6 8 8 3 2 3
2 4 7 9 4 8 5 2 3
8 9 1 6 9 1 1 3 3
6 9 3 7 3 8 6 4 2
6 9 7 1 3 9 4 7 2
3 7 1 5 1 6 5 5 4
9 8 2 4 9 8 6 6 1
7 7 9 8 8 9 1 1 1
7 5 2 5 3 9 4 5 6
0 0 2
8 8 8
