9 9
1 8 4 9 7 3 1 7 8
8 2 7 7 7 3 3 2 6
3 6 8 7 1 3 9 7 5
9 1 8 2 3 6 6 8 6
4 2 5 3 4 7 7 2 5
6 8 6 4 7 1 7 9 9
9 3 5 9 9 9 5 6 6
5 5 3 5 4 1 1 4 4
6 6 4 6 3 2 8 5 2
3 5 1
6 2 8
